000000000000000000000000000000000000000000000000000000000000
000000000000000000000000000000000000000000000000000000000000
000000000000000000000000000000000000000000000000000000000000
000000000000000000000000000000000000000000000000000000000000
000001111111111111111111111111111111111111111111111111110000
000001000000000000000000001100000110000000000000000000010000
000001000000000000000000001100000110010000000000000000010000
000001000000001000000000000100000100000000000000000000010000
000001000000000000000000000100000100000000000009000000010000
000001000000100110000000000100000100000000000000000000010000
000001000001100110000000000100000100000000000000000000010000
000001000001000010000000001111111110000000000000000000010000
000001000011000010000000000000000000000000000000000000010000
000001000011100110000000000000000000000000000000000000010000
000001000000000000000000000000000000000000000000000000010000
000001000000000000000000000110001100000000000111111000010000
000001000000000000000000000000000000000000001110000000010000
000001000000000000000000000011000000000000010000000000010000
000001000000000000000000000000001000000000011000000000010000
000001000000000000000000000000000000000000011110111000010000
000001000000000000000000000000000000000000000000000000010000
000001000000000000000000000000000001000000000000000000010000
000001000000000000000000000000000011000000000000000000010000
000001000000000000000000000000011000000000000000000000010000
000001000000000010010000000000000000000000000000000000010000
000001000000000000000000000000000000000000000000000000010000
000001000000000000000000000000000000000001100000000000010000
000001000000000000000011111100001111000000000000090000010000
000001000000001100001111001110000011111110000000000000010000
000001000000000000011122000000000000221110000000000000010000
000001000000000000111122000000000000222100000000000000010000
000001000000000000111222000000000000222111000000000000010000
000001000000000001110000000000000000000011000000000000010000
000001000000000001100000000000220000000011000000000000010000
000001000000000001100000000022222000000001100010000000010000
000001000900000001110000000222222200000001100000000000010000
000001000000000001110000002222222220000011100000000000010000
000001000000000000110000222222222222000011100000000000010000
000001000000011000110000002222222220000011000000000000010000
000001000000000001110000000022220000000011100000000000010000
000001000000100001110000000000000000000001100000000000010000
000001000000000001100000000000000000000011100000000000010000
000001000000010001100000000000000000000011100000000000010000
000001000000000001100000000000000000000011000110000000010000
000001000000000001100000000000000000000011000000000000010000
000001000900000001110000000000000000000011000000000000010000
000001000000000000111100011111111111000111000000000000010000
000001000000011000011101111111111111111110001100000000010000
000001000000000000001111110000000001111100000000090000010000
000001000000000000000000000000000000000000000000000000010000
000001000000000000000000000000000000000000000000000000010000
000001000000000011000000000000011011100000000000000000010000
000001000000000000000000000000000000001000000000000000010000
000001000000000000000000000009000000000000000000000000010000
000001000000000000000000000000000000000000000000000000010000
000001111111111111111111111111111111111111111111111111110000
000000000000000000000000000000000000000000000000000000000000
000000000000000000000000000000000000000000000000000000000000
000000000000000000000000000000000000000000000000000000000000
000000000000000000000000000000000000000000000000000000000000
