111111111111111111111111111111111111111111111111111111111111
111111111111111111111111111111111111111111111111111111111111
111111111111111111111111111111111111111111111111111111111111
111111111111111111111111111111111111111111111111111111111111
111111000000000000000000000000000000000000000000000000000001
111111000000000000000000000000000000000000000000000000000001
111111000000000000000000000000000000000000000000000000000001
111111000000000000000000000000000000000000000000000000000001
111111000000000000000000000000000000000000000000000000000001
111111000000000000001111111111111111111111111111111110000001
111111000000001111111777777777777777777777777777777710000001
111111000111117777777777977777777777777777777777777710000001
111111001777777777777777777777777777777777779777777710000001
111111001777777777777777777777777777777777777777777710000001
111111001777777777777777777777777711666611111111111111111111
111111001777777777777777777777777101555510000000000000000001
111111001777777777777777777777771111444411111100000000000001
111111001777777777111111111111111000000000000100000000000001
111111001777777771000000000000001000000000000100000000000001
111111001777977710000000000000110110000000000111111111111111
111111001777777710000000000000100000000000000000000000000001
111111001777777710000000000000100009000000000000000000000001
111111001777777710000000000000100000000000000000000000000221
111111001777777710000000000000100000000000000000000000000221
111111001777777710000000000000100000000900000000000000000221
111111001777777710000000000000100000000000000000000000000001
111111001777777710000000000000100000000000000000000000000001
111111001777777710000000000000010000000000001111111111111111
111111001177777110000000000000001000000000010000000000000001
111111000166666100000000000000000100000000100000000000000001
111111000155555100000000000000000011111111000000000000000001
111111000144444100000000000000000000000000000000000000000001
111111000100000111111111111111111000000000000000000000000001
111111111100000000101010101000001000000000000000000000011111
111111100000000000000000000000000111111111110000000000011111
111111100000009000000000000001100011111111110000000000011111
111111100000000000000000000000000000333300010000000000011111
111111100000000000000000000000000000000000010000000000011111
111111100000000000000000000000000000000000010000000000011111
111111100000000000000000000000000000000000010000000000011111
111111010000000000000000000000000009000000010000000000011111
111111001000000011111111110000000000000000010000000000011111
111111000111111100000000010000000000000000010000000000011111
111111000000000000000000001111111111111111110000000000011111
111111000000000000000000000000000000000000000000000000011111
111111000000000000000000000000000000000000000000000000011111
111111000000000000000000000000000000000000000000000000011111
111111000000000000000000000000000000000000000000000000011111
111111000000000000000000000000000000000000000000000000011111
111111000000000000000000000000000000000000000000000000011111
111111000000000000000000000000000000000000000000000000011111
111111000000000000000000000000000000000000000000000000011111
111111000000000000000000000000000000000000000000000000011111
111111000000000000000000000000000000000000000000000000011111
111111000000000000000000000000000000000000000000000000011111
111111111111111111111111111111111111111111111111111111111111
111111111111111111111111111111111111111111111111111111111111
111111111111111111111111111111111111111111111111111111111111
111111111111111111111111111111111111111111111111111111111111
111111111111111111111111111111111111111111111111111111111111
