000000000000000000000000000000000000000000000000000000000000
000000000000000000000000000000000000000000000000000000000000
000000000000000000000000000000000000000000000000000000000000
000000000111111111100000000111111110000000000000000000000000
000000000111111111100001111100000011111100000000000000000000
000000000111000000111111000000000000000110000000000000000000
000000001100000000000000000001000000000010000000000000000000
000000001100000000000000000000000000000010000000000000000000
000000011100110000000000000000000000110011000000000000000000
000000011000110110000000000000000000110001000000000000000000
000000011000100000000000000000000000000001000000000000000000
000000010000000000000000000000000000000001000000000000000000
000000010000000000000000000000000000000001000000000000000000
000000110000000000000000000000000000000001000000000000000000
000000110000000000000000000000000000000001100000000000000000
000000100000000000000000000000000000000000100000000000000000
000001100000001000000000000000000000000000100000000000000000
000001100000000000000000000000000000000001100000000000000000
000001000000000000000000000000000000000011100000000000000000
000001000000000000000000000000000000000011000000000000000000
000011000000000000000000000000000000000010000000000000000000
000011000000000000000000000000000000001110000000000000000000
000010000000000000000000000000000000001110000000000000000000
000010000001100000000000000000000000001000000000000000000000
000010000000000000000000000000000000001000000000000000000000
000010000000000000000000000000000000001000000000000000000000
000011000000000000000000000000000000001100000000000000000000
000001000000000000000000000000000000000100000000000000000000
000001000000000000000000000000000000000100000000000000000000
000001000000100000000000000000000000000100000000000000000000
000001000001100000000000001100000000000100000000000000000000
000001100000000000000000000000000000001100000000000000000000
000000100000000000000000000000000000001100000000000000000000
000000100000000000010000011000000110001000000000000000000000
000000100110000000000000000000000110001000000000000000000000
000000100110000000000000000000000000111000000000000000000000
000000100000000000000000000000000000111000000000000000000000
000000100000000000000000000000000000100000000000000000000000
000000111111000111110000000000000011100000000000000000000000
000000000001111100010000011111111110000000000000000000000000
000000000000000000010000110000000000000000000000000000000000
000000000000000000110000010000000000000000000000000000000000
000000000000000000110001110000000000000000000000000000000000
000000000000000000100001110000000000000000000000000000000000
000000000000000000100001000000000000000000000000000000000000
000001111111110001100001000000000000000000000000000000000000
000011000011111001100001000000000000000000000000000000000000
000110000110011001000001000000000000000000000000000000000000
000100001110001001000001000000000000000000000000000000000000
000100111100001111000111000000000000000000000000000000000000
000111100000011111000111000000000000000000000000000000000000
000100000000000000000100000000000000000000000000000000000000
000100000000000000000100000000000000000000000000000000000000
000100010000000000000100000000000000000000000000000000000000
000100000000001000011100000000000000000000000000000000000000
000110000000000000010000000000000000000000000000000000000000
000011000000000000110000000000000000000000000000000000000000
000001110011111001100000000000000000000000000000000000000000
000000011110001111000000000000000000000000000000000000000000
000000000000000000000000000000000000000000000000000000000000
