111111111111111111111111111111111111111111111111111111111111
100000000000000000000000000000000000000000000000000000000001
100000000000000000000000000000000000000000000000000000000001
100111111111000000000000000000111111100000000000000000000001
101777777777110000000000001111777777111111100000000000000001
101777777779771100000001117777777777777777111111110000000001
100177777777777711111117777777777797777777777777711100000001
100011177777777777777777777777777777777777777777777111000001
100000011177777777777777771111177711111117777777777771100001
100000000011117777777771110000166610000011111111777777110001
100000000000001117777110000000155510000000000001117777711001
100000000000000011111000000000144410000000000000011777771001
100000000000000000000000000000100010000000000000001177771001
100000000000000000000000000000100010000000000000000117771001
100000000000000000000000000000100010000000000000000017771001
100000000000000000000000000000100010000000000000000017771001
100000000000000000000000000000100010000000000000000017771001
100000000000000000000000000000100010000000000000000017771101
100000000000000111111111110001000010000000000000000017777101
100000000000011000000000001110000100000000000000000011777101
100000000000100000000000000000000100000000000000000001777101
100000000001000000000000000900000100000000000000000001777101
100000000010000011111111100000000010000000000000000001777101
100000000100001100000000011110000001000000000000000001777101
100000001000010000000000000001000000100000000000000001777101
100000010000100000000000000000110000010000000000000001777101
100000010001000000000000000000001000010000000000000001777101
100000010001000000000000000000001000010000000000000001777101
100000010001000000000000000000000100010000000000000001777101
100000010001000000000000000000000100001000000000000001777101
100000010001000000000000000000000010001000000000000001797101
100000010000100000000000000000000010001000000000000001777101
100000001000110000000000000000000001000100000000000011777101
100000001000001100000000000000000001000100000000000017777111
100000000109000011000000000000000001000100000000000017777711
100000000010000000100000000000000001090100000000000017777711
100000000001110000010000000000000001000100000000000117777711
100000000000001100001000000000000001000100000000000177777771
100000000000000010000100000000000001000100000000000177777771
100000000000000001000010000000000010001000000000000177777771
100000000000000000100010000000000010001000000000000177777771
100000000000000000100010000000000010001000000000001177777771
100000000000000000100010000000000010001000000000001777777771
100000000000000000100010000000000010001000000000011777777771
100000000000000111000001111000000010001000000000117777777771
100000000000001000000000000100000010001000000000177777777771
100000000001110000000000000011110010001000000000177777777771
100000000010000000000000000000001100001000000000177777777771
100000000100000000000111100000000000001100000000177797777711
100000001000000001111000011100000000000011111000177777777711
100000010000111110000000000011110000000900000100177777777711
100000010001000000000000000000001100000000000100117777797711
100000100010000000000000000000000011111000000100017777777111
111111000010000000000000000000000000000111111000011777771101
122000000100000000000000000000000000000000000000001111111001
122000001000000000000000000000000000000000000000000000000001
122000010000000000000000000000000000000000000000000000000001
111111100000000000000000000000000000000000000000000000000001
100000000000000000000000000000000000000000000000000000000001
111111111111111111111111111111111111111111111111111111111111
