111111111111111111111111111111111111111111111111111111111111
111111111111111111111111111111111111111111111111111111111111
111111111111111111111111111111111111111111111111111111111111
111111111111111111111111111111111111111111111111111111111111
111111000000000000000000000000000000000000000000000000000001
111111000000000000000000000000000000000000000000000000000001
111111000000000000000000000000000000000000000000000000000001
111111000000000000000000000000000000000000000000000000000001
111111000000000000000000000000000000000000000000000000000001
111111000000000000001111111111111111111111111111111110000001
111111000000001111111000000000000000000000000000000010000001
111111000111110000000000000000000000000000000000000010000001
111111001000000000000000000000000000000000000000000010000001
111111001000000000000000000000000000000000000000000010000001
111111001000000000000000000000000011000011111111111111111111
111111001000000000000000000000000101000010000000000000000001
111111001000000000000000000000000000000000000000000000000001
111111001000000000000000000000000000000000000000000000000001
111111001000000000000000000000000000000000000000000000000001
111111001000000000000000000000000000000000000000000000000001
111111001000000000000000000000000000000000000000000000000001
111111001000000000000000000000000000000000000000000000000001
111111001000000000000000000000000000000000000000000000000001
111111001000000000000000000000000000000000000000000000000001
111111001000000000000000000000000000000000000000000000000001
111111001000000000000000000000000000000000000000000000000001
111111001000000000000000000000000000000000000000000000000001
111111001000000000000000000000000000000000000000000000000001
111111000000000000000000000000000000000000000000000000000001
111111000100000000000001111111111111100000000000000000000001
111111000000000000000010000000000000010000000000000000000001
111111000000000000000100000000000000001100000000000000000001
111111000000000000001000000000000000000110000000000000000001
111111100000000000010000000000000000000011000000000000011111
111111100000000000100000000000000000000001000000000000011111
111111100000000000100000000000000000000001000000000000011111
111111100000000000100000000000000000000001000000000000011111
111111100000000000100000000000000000000001000000000000011111
111111100000000000100000000000000000000001000000000000011111
111111100000000000100000000000000000000001000000000000011111
111111010000000000100000000000000000000001000000000000011111
111111001000000000100000000000000000000001000000000000011111
111111000000000000100000000000000000000001000000000000011111
111111000000000000100000000000000000000001000000000000011111
111111000000000000100000000000000000000001000000000000011111
111111000000000000100000000000000000000001000000000000011111
111111000000000000100000000000000000000001000000000000011111
111111000000000000010000000000000000000010000000000000011111
111111000000000000001000000000000000000100000000000000011111
111111000000000000000100000000000000001000000000000000011111
111111000000000000000010000000000000010000000000000000011111
111111000000000000000001000000000000100000000000000000011111
111111000000000000000011111100001111110000000000000000011111
111111000000000000000000000133331000000000000000000000011111
111111000000000000000000000111111000000000000000000000011111
111111111111111111111111111111111111111111111111111111111111
111111111111111111111111111111111111111111111111111111111111
111111111111111111111111111111111111111111111111111111111111
111111111111111111111111111111111111111111111111111111111111
111111111111111111111111111111111111111111111111111111111111
